########  ######
#      #### .  #
#  $  $  .   $ #
#       . $    #
# +  $ #### *  #
#   .  #  #   .#
########  ######