
    XXXXXXXXXXXX  
    X..  X     XXX
    X..  X $  $  X
    X..  X$XXXX  X
    X..    @ XX  X
    X..  X X  $ XX
    XXXXXX XX$ $ X
      X $  $ $ $ X
      X    X     X
      XXXXXXXXXXXX