########
#      ######
#  $     .  #
# $ $       # 
# + .  #   ####
#      #      #
########   .  #
       ########