########
#      ######
#  $  $  .  #
# $       $ # 
# + .  #   ####
#    . #      #
########   .  #
#  $          #
#   .    ######
##########