########
#      ######
#   $    .  #
# $    $    # 
# + .  #   ####
#   .  # $  $ #
########   .  #
       ########